
                     F 3,1 ,1             
C  2,251,50

           EA textures/brown.xpm
NO textures/wall_texture.xpm
      WE textures/t.xpm
   SO textures/a.xpm

111 1111111
101 1000001
1N1 1000001
111 1111111
11111111111
10111111111
1111