
NO textures/wall_texture.xpm
SO textures/a.xpm
EA textures/brown.xpm
WE textures/t.xpm

C 173,216,230
F 139, 134, 130

 11111111111111111111111111111111111111111111111
 10000000000000000111111111111110000000000000001
 10000000000000000111111111111110000000000000001
 10000000000000000111111111111111111111000000001
 10000000000000000111111111111111111111000000001
 10000000000000000111111111111111111111000000001
 1111000000000000011111111111111111111111000000111
    11110000000000000111111111111111111111110000001
    111110000000000000111111111111111111111110000001
 11111000000000000000000000000000000000000000000111
 10000000000000000000000000000000000000000000001
 10000000000000000011110000000000000000000000001
 10000000000000000011110000001000000000000000001
 10000000000000000000000000000000000000000000001
 11111111111111000000000000000000001111111111111
 11111111111111111000000000000011111111111111111
 111111111111111111110000N0011111111111111111111
 11111111111111111111111111111111111111111111111
111111111111111111111111                          1
                1               11           1   101
                1               11           1   111
11111111111111111111111111111111111111111111111111111111111111111111