
                     F 3,1 ,1             
C  2,251,50

           EA textures/brown.xpm
NO textures/wall_texture.xpm
      WE textures/t.xpm
   SO textures/a.xpm

11111111111
10000000001
1N000000001
11001111111
11111111111
10111111111
1111