NO textures/a.xpm
SO textures/wall_texture.xpm
EA textures/t.xpm 
WE textures/t.xpm




C 2 20,20,20
F 255,0,0

1111
1001
1N01
1111