
SO textures/wall_texture.xpm
EA textures/t.xpm 
NO textures/a.xpm

WE textures/t.xpm


F  0,50,50
C 20,20,20

1111
1001
10N1
1001
1001
1111


