NO textures/a.xpm
SO textures/t.xpm
WE textures/t.xpm
EA textures/t.xpm 

F 20,20,20
C 20,200,200


11111
10001
10001
10001    11111111
10001    1110N001
11111    11100001
10001    11111111
11001
10001
10001
10001
10001
11111
