
SO textures/wall_texture.xpm
EA textures/t.xpm
NO textures/a.xpm

WE textures/t.xpm


C 1,20,20
F 0,50,50


1111
1001
101
1001
1001
1111

