NO textures/a.xpm
SO textures/t.xpm
WE textures/t.xpm
EA textures/t.xpm 

F 20,20,20
C 20,200,200


11111
10001
10001
10N1
10001
11111
10001
11001
10001
10001
10001
10001
11111
