NO textures/a.xpm
SO textures/t.xpm
WE textures/t.xpm
EA textures/t.xpm 


C 20,200,200
C 20,200,200
F 20,20,20

 11111
 10001
 1N001
 10001
 10001
 11111
 10001
 11001
 10001
 10001
 10001
 10001
 11111
 

