
NO textures/a.xpm
SO textures/wall_texture.xpm
WE textures/t.xpm
EA textures/a.xpm



F	25,50,50
C 11,20,20


1111
1001
1N01
1001
1001
1111

