1111111111
1000100001
1000100101
1000100101
1000100001
1000000001
1000011001
1000011001
1000000001
1111111111
