NO ./path/to/north_texture.xpm
SO ./path/to/south_texture.xpm
EA ./path/to/east_texture.xpm
WE ./path/to/west_texture.xpm



F 220,100,0
C 225,30,0


111111111111111111111111111111111111111111111111111111111111
100010000000000000000000000000000000000000000000000000000001
100010010000000000000000000000000000000000000000000000000001
100010010000000000000000000000000000000000000000000000000001
100010000000000000000000000000000000000000000000000000000001
100010010000000000000000000000000000000000000000000000000001
100010000000000000000000000000000000000000000000000000000001
100010010000000000000000000000000000000000000000000000000001
100010000000000000000000000000000000000000000000000000000001
100010010000000000000000000000000000000000000000000000000001
100010000000000000000000000000000000000000000000000000000001
100010010000000000000000000000000000000000000000000000000001
100010000000000000000000000000000000000000000000000000000001
100010010000000000000000000000000000000000000000000000000001
100010000000000000000000000000000000000000000000000000000001
100010010000000000000000000000000000000000000000000000000001
100010000000000000000000000000000000000000000000000000000001
100010010000000000000000000000000000000000000000000000000001
100010000000000000000000000000000000000000000000000000000001
100010010000000000000000000000000000000000000000000000000001
100010000000000000000000000000000000000000000000000000000001
100010010000000000000000000000000000000000000000000000000001
111111111111111111111111111111111111111111111111111111111111
