1111111111
1000100001
1000100101
1111111111
