NO ./path/to/north_texture.xpm
SO ./path/to/south_texture.xpm
WE ./path/to/west_texture.xpm
EA ./path/to/east_texture.xpm
F 220,100,0
C 225,30,0


1111111111111111111
10S00000000000000011
10000000000000000011
11111111111111111111
100000000000000001         
1111111111111111111
1000000000000000001
1111111111111111111
















