NO ./textures/north_texture.xpm
SO ./path/to/south_texture.xpm
WE ./path/to/west_texture.xpm
EA ./path/to/east_texture.xpm

C 173,216,230
F 139, 134, 130


11111111111111111111111111111111111111111111111
10000000000000000111111111111110000000000000001
10000000000000000111111111111110000000000000001
10000000000000000111111111111111111111000000001
10000000000000000111111111111111111111000000001
10000000000000000111111111111111111111000000001
11110000000000000111111111111111111111110000001
11110000000000000111111111111111111111110000001
11110000000000000111111111111111111111110000001
10000000000000000000000000000000000000000000001
10000000000000000000000000000000000000000000001
10000000000000000011110000000000000000000000001
10000000000000000011110000001000000000000000001
10000000000000000000000000000000000000000000001
11111111111111000000000000000000001111111111111
11111111111111111000000000000011111111111111111
111111111111111111110000N0011111111111111111111
11111111111111111111111111111111111111111111111