NO ./../textures/wall_n.xpm
SO ./../textures/wall_s.xpm
WE ./../textures/wall_w.xpm
EA ./../textures/wall_e.xpm



F 111,100,110
C 100,35,243



111111111111111111111
100000000000000000001
100000000000000000001
100000000000000000001
1000000N0000000000001
11111111111111111111
                    
111111111111111111111
                     
11111111111111111111
100000000000000000001
100000000000000000001
100000000000000000001
100000000000000000001
111111111111111111111



