NO ./path/to/north_texture.xpm
SO ./path/to/south_texture.xpm
WE ./path/to/west_texture.xpm
EA ./path/to/east_texture.xpm
F 220,100,0
C 225,30,0

  111111111111111111111111111111111111111111
1100101011111100000000000000000000000000000001
100000000000000000001       10000001111111             
    1000011111100000000111111110000000000001
1110111000000000000001      1000000000001
11100001000000000000001      10000000000011
101000000000000000001111111111000000000011
1111110000000000000N00000000000000000001111
100000000000000000000000000000000000001
1111111111111111111111111111111111111111111
