NO ./path/to/north_texture.xpm
SO ./path/to/south_texture.xpm
WE ./path/to/west_texture.xpm
EA ./path/to/east_texture.xpm
F 220,100,0
C 225,30,0


	111111111111111111111
 11110S00000000000000011
 100000000000000000111
 11111111111111111111
 11111111111111111
 100000000000000001     
 11111111111111111          
 1111111111111111111111 

