NO ./path/to/north_texture.xpm
SO ./path/to/south_texture.xpm
WE ./path/to/west_texture.xpm
EA ./path/to/east_texture.xpm
F 220,100,0
C 225,30,0


                  
 111111111111111111111111111111111111111111111
11001010111111000000000000000000000000000W1
10000000000000000000100000100000011111111111
111100001111110000000011111111000000000001
11101110000000000000011   100000000001111111
111000010000000000000011110000000001111
10100000000000000001111111111000000000011
111111000000000000000000000000000000001111
100000000000000000000000000000000000001
1111111111111111111111111111111111111111111
