NO ./path/to/north_texture.xpm
SO ./path/to/south_texture.xpm
WE ./path/to/west_texture.xpm
EA ./path/to/east_texture.xpm
F 220,100,0
C 225,30,0

1111111111111111111111111111111111111111111
      1000000000000000000000000001111111111
1111111011111100000000111111110000000000001
10000001000000000000001      1000000000000111111
10100N01000000000000001      1000000000000111111
1010000000000000000000111111110000000000001
1011110000000000000000000000000000000001111
100000000000000000000000000000000000001
1111111111111111111111111111111111111111111
