NO textures/wall_texture.xpm
WE textures/t.xpm
SO textures/t.xpm
EA textures/brown.xpm


F 220,100,0
C 225,30,0

111111111111111111111111
100000000000000000000001
100000000000000000000001
100000000000000000000001
100000000000000000000001
100000000011110000000001
100000000011110000000001
100000000011110000000001
100000000010000000000001
100000000000000000000001
100000000000000000000001
100000000000000000000001
100000000000000S00000001
100000000000000000000001
111111111111111111111111