NO ./../textures/wall_n.xpm
SO ./../textures/wall_s.xpm
WE ./../textures/wall_w.xpm
EA ./../textures/wall_e.xpm



F 1,1,1
C 10,1,20



 11111111111111111111
 1000010100000000001
11000010100000000111
 100100000000000011111111
 100000000111000000000001111111
 1000000000010000011111111
 10000000011100000001111
 10000000011111101111111111
 10000000011111101111111111
 10000000011111101111111111
 100000000000000011111111
 10000000011111111111111111
 1000000011111111111111111
 111111111111111111111111