NO ./../textures/wall_n.xpm
SO ./../textures/wall_s.xpm
WE ./../textures/wall_w.xpm
EA ./../textures/wall_e.xpm



F 111,100,110
C 100,35,243



11111111111111111111111111111111111111111111111111111
100000000000000000000000000000000000000000000000000001
100000000000000000000000000000000000000011110000000001
100000000000000000000000000000000000000000000000000001
1000000N0000000000000000000000000000000000000000000001
100000000000000000000000000000000000000000000000000001
100000000000000000000000000000000000000000000000000001
100000000000000000000000000000000000000000000000000001
100000000000000000000000000000000000000000000000000001
100000000000000000000000000000000000000000000000000001
100000000000000000000000111111111111111111000000000001
100000000000000000000000111111111111111111000000000001
100000000000000000000000000000000000000000000000000001
100000000000000000000000000000000000000000000000000001
100000000000000000000000000000000000000000000000000001
100000000000000000000000000000000000000111100000000001
100000000000000000000000000000000000000111110000000001
100000000001111111111111000000000000000000000000000001
100000000001111111111111000000000000000000000000000001
100000000000111111111111000000000000000000000000000001
100000000000000000000000000000000000000000000000000001
100000000000000000000000000000000000000000000000000001
100000000000000000000000000000000000000000000000000001
100000000000000000000000000000000000000110000000000001
100000000000000000000000000000000000000000000000000001
100000000000000000000111000000000000000000000000000001
100000000000000000000000000000000000000000000000000001
100000000000000000000000000000000000011100000000000001
1000000000000000000000000000000000000001000000000000001
10000000000000000000000000000000000000000000000000000001
10000000000000000000000000000000000000000000000000000111
11111111111111111111111111111111111111111111111111111111