NO textures/wall_texture.xpm
SO textures/a.xpm
EA textures/brown.xpm
WE textures/t.xpm

C 173,216,230
F 139, 134, 130

111111111111111
100000000000001
100000000000001
100000000000001
100000000000001
100000111000001
100000111000001
100000001000001
100000000000001
100000000000001
100N00000000001
100000000000001
100000000000001
100000000000001
111111111111111