NO ./path/to/north_texture.xpm
SO ./path/to/south_texture.xpm
WE ./path/to/west_texture.xpm
EA ./path/to/east_texture.xpm
F 220,100,0
C 225,30,0

1111111111
    1000000001
1011111101
1010000101
10100N0101
1010000101
1011111101
1000000001
1111111111