NO ./path/to/north_texture.xpm
SO ./path/to/south_texture.xpm
WE ./path/to/west_texture.xpm
EA ./path/to/east_texture.xpm
F 220,100,0
C 225,30,0

1111111111111111111111111111111111111111111
      111111000000000000000000000000000000001
      10000000000000001       10000001
      0011111100000000111111110000000000001
111111110000000E0000001      10000000000001
10100001000000000000001      10000000000001
1010000000000000000000111111110000000000001
1011110000000000000000000000000000000001111
100000000000000000000000000000000000001
1111111111111111111111111111111111111111111