NO ./textures/a.xpm
SO ./textures/t.xpm
EA ./textures/brown.xpm
WE ./textures/wall_texture.xpm



C 225,30,0
F 220,100,0


1111111111111111111111111
1000000000000000000000001
1000000000000000000000001
1111100000000000000000001
1111111110000000000000001
1111111110000000000000011
1111111110000000000000011
1111111000000000000000011
1111100000000000000000001
1000000000000000000000001
1000000000000000000000001
1000000000000111000000001
1000000000000011000000001
1000000000000000000000001
1000000000000000000000001
1000000000000000000000001
10000000000N0000000000001
1111111111111111111111111